R 800 600

NO ./textures/N.xpm
SO ./textures/S.xpm
EA ./textures/E.xpm
WE ./textures/W.xpm

S ./textures/SP.xpm

F 000,100,000
C 80,80,120

111111111111111
1100100S0000201
110200000100011
110000010010001
100120000010201
100100000010001
111111111111111